R  750 750
NO ./texture/north.xpm 
SO ./texture/south.xpm
WE ./texture/west.xpm
EA ./texture/east.xpm

S ./texture/sprite.xpm
F 119,232,106
C 116,217,222

        1111111111111111111111111
        100000000011000000000000111
        101100000111000000000000001
        100100200000000000000000001111
11111111101100N00111000000000000000001
1000000000110000011101111110111111111111
111101111111110111000000100010000000001
1111011111111101110101001000111111111111111111111111111111111111111111111111
1100000011010101110000001000100000000000000000000000000000000000000000000001
1000000000000000110000001000000000000000000000000000000000000000000000000001
1000000000000000110101001000111111111111111111111111111111111111111111111111
110000011101010111110111100011
11110111 1110101 101111010001
11111111 1111111 111111111111
