R  750 750
NO ./texture/north.xpm 
SO ./texture/south.xpm
WE ./texture/west.xpm
EA ./texture/east.xpm

S ./texture/sprite.xpm
F 220,255,250
C 255,0,0

        1111111111111111111111111
        100000000011000000000000111
        101100000111000000200000001
        100100000000000000000000001111
11111111101100N00111000000000000000001
1000000000110000011101111110111111111111
111101111111110111000000100010000000001
111101111111110111010100100011111111111
11000000110101011100000010001
10002000000000001100000010001
10000000000000001101010010001
110000011101010111110111100011
11110111 1110101 101111010001
11111111 1111111 111111111111
