R  520 1080 
NO ./texture/north.xpm 
SO ./texture/south.xpm
WE ./texture/west.xpm
EA ./texture/east.xpm

S ./texture/sprite.xpm
F 220,255,250
C 255,0,0

        11111111111111111111111111
        10000000001100000000000011
        10110W000111000000200000001
        10010000000000000000000011111
11111111101100000111000000000000000001
10000000001100000111011111111111111111
111101111111110111000000100010000000001
11110111111111011101010010001111111111
11000000110101011100000010001
10002000000000001100000010001
10000000000000001101010010001
110000011101010111110111100011
11110111 1110101 101111010001
11111111 1111111 111111111111
