R  750 750
NO ./texture/north.xpm 
SO ./texture/south.xpm
WE ./texture/squall.xpm
EA ./texture/east.xpm

S ./texture/sprite.xpm
F 119,232,106
C 116,217,222

        1111111111111111111111111
        100000000011000000000000111
        101100000111100200000000001
        100100000000000000000000001111
11111111101100000111000000000000000001
1000000000110000011101111110111111111111
111101111111110111000000100010000000001
1111011111111101110101001000111111111111111111111111111111111111111111111111
1100000011010101110000001000100000000000000000000000000000000000000000000001
1000022000E00000110000001000000000000000000000000000000000000000000000000001
1222220022200000110101001000111111111111111111111111100000000001111111111111
1100000111010101111101111000111111111111111111111111100000000001111111111111
11110111 1110101 10111101000111111111111111111111111111111111111111111111111
11111111 1111111 111111111111
