R  600 600
NO ./texture/north.xpm 
SO ./texture/south.xpm
WE ./texture/west.xpm
EA ./texture/east.xpm

S ./texture/sprite.xpm 
F 119,232,106
C 116,217,222

1111111111111111
1222222222222221
1222222222222221
1222220002222221
1222220N02222221
1222220002222221
1222222222222221
1222222222222221
1111111111111111
